2
86
30

   0    0    0    0    0    0    0    0    0    0    0    0    0    0    0    0    0    0    0    0    0    0    0    0    0    0    0    0    0    0
   0    0    0    0    0    0    0    0    0    0    0    0    0    0    0    0    0    0    0    0    0    0    0    0    0    0    0    0    0    0
   0    0    0    0    0    0    0    0    0    0    0    0    0    0    0    0    0    0    0    0    0    0    0    0    0    0    0    0    0    0
   0    0    0    0    0    0    0    0    0    0    0    0    0    0    0    0    0    0    0    0    0    0    0    0    0    0    0    0    0    0
   0    0    0    0    0    0    0    0    0    0    0    0    0    0    0    0    0    0    0    0    0    0    0    0    0    0    0    0    0    0
   0    0    0    0    0    0    0    0    0    0    0    0    0    0    0    0    0    0    0    0    0    0    0    0    0    0    0    0    0    0
   0    0    0    0    0    0    0    0    0    0    0    0    0    0    0    0    0    0    0    0    0    0    0    0    0    0    0    0    0    0
   0    0    0    0    0    0    0    0    0    0    0    0    0    0    0    0    0    0    0    0    0    0    0    0    0    0    0    0    0    0
   0    0    0    0    0    0    0    0    0    0    0    0    0    0    0    0    0    0    0    0    0    0    0    0    0    0    0    0    0    0
   0    0    0    0    0    0    0    0    0    0    0    0    0    0    0    0    0    0    0    0    0    0    0    0    0    0    0    0    0    0
   0    0    0    0    0    0    0    0    0    0    0    0    0    0    0    0    0    0    0    0    0    0    0    0    0    0    0    0    0    0
   0 2017 2017 2111    0    0    0    0    0    0    0    0    0    0    0    0    0    0    0    0    0    0    0    0    0    0    0    0    0    0
   0    0    0    0    0    0    0    0    0    0    0    0    0    0    0    0    0    0    0    0    0    0    0    0    0    0    0    0    0    0
   0    0    0    0    0    0    0    0    0    0    0    0    0    0    0    0    0    0    0    0    0    0    0    0    0    0    0    0    0    0
   0    0    0    0    0    0    0    0    0    0    0    0    0    0    0    0    0    0    0    0    0    0    0    0    0    0    0    0    0    0
   0    0    0    0    0    0    0    0    0    0    0    0    0    0    0    0    0    0    0    0    0    0    0    0    0    0    0    0    0    0
   0    0    0    0    0    0    0    0    0    0    0    0    0    0    0    0    0    0    0    0    0    0    0    0    0    0    0    0    0    0
   0 2111 2115 2017    0    0    0    0    0    0    0    0    0    0    0    0    0    0    0    0    0    0    0    0    0    0    0    0    0    0
   0    0    0    0    0    0    0    0    0    0    0    0    0    0    0    0    0    0    0    0    0    0    0    0    0    0    0    0    0    0
   0    0    0    0    0    0    0    0    0    0    0    0    0    0    0    0    0    0    0    0    0    0    0    0    0    0    0    0    0    0
   0    0    0    0    0    0    0    0    0    0    0    0    0    0    0    0    0    0    0    0    0    0    0    0    0    0    0    0    0    0
   0    0    0    0    0    0    0    0    0    0    0    0    0    0    0    0    0    0    0    0    0    0    0    0    0    0    0    0    0    0
   0    0    0    0    0    0    0    0    0    0    0    0    0    0    0    0    0    0    0    0    0    0    0    0    0    0    0    0    0    0
   0    0    0    0    0    0    0    0    0    0    0    0    0    0    0    0    0    0    0    0    0    0    0    0    0    0    0    0    0    0
   0    0    0    0    0    0    0    0    0    0    0    0    0    0    0    0    0    0    0    0    0    0    0    0    0    0    0    0    0    0
   0    0    0    0    0    0    0    0    0    0    0    0    0    0    0    0    0    0    0    0    0    0    0    0    0    0    0    0    0    0
   0    0    0    0    0    0    0    0    0    0    0    0    0    0    0    0    0    0    0    0    0    0    0    0    0    0    0    0    0    0
   0    0    0    0    0    0    0    0    0    0    0    0    0    0    0    0    0    0    0    0    0    0    0    0    0    0    0    0    0    0
   0    0    0    0    0    0    0    0    0    0    0    0    0    0    0    0    0    0    0    0    0    0    0    0    0    0    0    0    0    0
   0    0    0    0    0    0    0    0    0    0    0    0    0    0    0    0    0    0    0    0    0    0    0    0    0    0    0    0    0    0
   0    0    0    0    0    0    0    0    0    0    0    0    0    0    0    0    0    0    0    0    0    0    0    0    0    0    0    0    0    0
   0    0    0    0    0    0    0    0    0    0    0    0    0    0    0    0    0    0    0    0    0    0    0    0    0    0    0    0    0    0
   0    0    0    0    0    0    0    0    0    0    0    0    0    0    0    0    0    0    0    0    0    0    0    0    0    0    0    0    0    0
   0    0    0    0    0    0    0    0    0    0    0    0    0    0    0    0    0    0    0    0    0    0    0    0    0    0    0    0    0    0
   0    0    0    0    0    0    0    0    0    0    0    0    0    0    0    0    0    0    0    0    0    0    0    0    0    0    0    0    0    0
   0    0    0    0    0    0    0    0    0    0    0    0    0    0    0    0    0    0    0    0    0    0    0    0    0    0    0    0    0    0
   0    0    0    0    0    0    0    0    0    0    0    0    0    0    0    0    0    0    0    0    0    0    0    0    0    0    0    0    0    0
   0    0    0    0    0    0    0    0    0    0    0    0    0    0    0    0    0    0    0    0    0    0    0    0    0    0    0    0    0    0
   0    0    0    0    0    0    0    0    0    0    0    0    0    0    0    0    0    0    0    0    0    0    0    0    0    0    0    0    0    0
   0    0    0    0    0    0    0    0    0    0    0    0    0    0    0    0    0    0    0    0    0    0    0    0    0    0    0    0    0    0
2111 2017 2114 2111    0    0    0    0    0    0    0    0    0    0    0    0    0    0    0    0    0    0    0    0    0    0    0    0    0    0
   0    0    0    0    0    0    0    0    0    0    0    0    0    0    0    0    0    0    0    0    0    0    0    0    0    0    0    0    0    0
   0    0    0    0    0    0    0    0    0    0    0    0    0    0    0    0    0    0    0    0    0    0    0    0    0    0    0    0    0    0
   0    0    0    0    0    0    0    0    0    0    0    0    0    0    0    0    0    0    0    0    0    0    0    0    0    0    0    0    0    0
   0    0    0    0    0    0    0    0    0    0    0    0    0    0    0    0    0    0    0    0    0    0    0    0    0    0    0    0    0    0
   0    0    0    0    0    0    0    0    0    0    0    0    0    0    0    0    0    0    0    0    0    0    0    0    0    0    0    0    0    0
   0    0    0    0    0    0    0    0    0    0    0    0    0    0    0    0    0    0    0    0    0    0    0    0    0    0    0    0    0    0
   0    0    0    0    0    0    0    0    0    0    0    0    0    0    0    0    0    0    0    0    0    0    0    0    0    0    0    0    0    0
   0    0    0    0    0    0    0    0    0    0    0    0    0    0    0    0    0    0    0    0    0    0    0    0    0    0    0    0    0    0
   0    0    0    0    0    0    0    0    0    0    0    0    0    0    0    0    0    0    0    0    0    0    0    0    0    0    0    0    0    0
   0    0    0    0    0    0    0    0    0    0    0    0    0    0    0    0    0    0    0    0    0    0    0    0    0    0    0    0    0    0
   0    0    0    0    0    0    0    0    0    0    0    0    0    0    0    0    0    0    0    0    0    0    0    0    0    0    0    0    0    0
   0    0    0    0    0    0    0    0    0    0    0    0    0    0    0    0    0    0    0    0    0    0    0    0    0    0    0    0    0    0
   0 2111 2115 2017    0    0    0    0    0    0    0    0    0    0    0    0    0    0    0    0    0    0    0    0    0    0    0    0    0    0
   0    0    0    0    0    0    0    0    0    0    0    0    0    0    0    0    0    0    0    0    0    0    0    0    0    0    0    0    0    0
   0    0    0    0    0    0    0    0    0    0    0    0    0    0    0    0    0    0    0    0    0    0    0    0    0    0    0    0    0    0
   0    0    0    0    0    0    0    0    0    0    0    0    0    0    0    0    0    0    0    0    0    0    0    0    0    0    0    0    0    0
   0    0    0    0    0    0    0    0    0    0    0    0    0    0    0    0    0    0    0    0    0    0    0    0    0    0    0    0    0    0
   0    0    0    0    0    0    0    0    0    0    0    0    0    0    0    0    0    0    0    0    0    0    0    0    0    0    0    0    0    0
   0    0    0    0    0    0    0    0    0    0    0    0    0    0    0    0    0    0    0    0    0    0    0    0    0    0    0    0    0    0
   0    0    0    0    0    0    0    0    0    0    0    0    0    0    0    0    0    0    0    0    0    0    0    0    0    0    0    0    0    0
   0    0    0    0    0    0    0    0    0    0    0    0    0    0    0    0    0    0    0    0    0    0    0    0    0    0    0    0    0    0
   0    0    0    0    0    0    0    0    0    0    0    0    0    0    0    0    0    0    0    0    0    0    0    0    0    0    0    0    0    0
   0 2017 2111 2111    0    0    0    0    0    0    0    0    0    0    0    0    0    0    0    0    0    0    0    0    0    0    0    0    0    0
   0    0    0    0    0    0    0    0    0    0    0    0    0    0    0    0    0    0    0    0    0    0    0    0    0    0    0    0    0    0
   0    0    0    0    0    0    0    0    0    0    0    0    0    0    0    0    0    0    0    0    0    0    0    0    0    0    0    0    0    0
   0    0    0    0    0    0    0    0    0    0    0    0    0    0    0    0    0    0    0    0    0    0    0    0    0    0    0    0    0    0
   0    0    0    0    0    0    0    0    0    0    0    0    0    0    0    0    0    0    0    0    0    0    0    0    0    0    0    0    0    0
   0 2111 2111 2017    0    0    0    0    0    0    0    0    0    0    0    0    0    0    0    0    0    0    0    0    0    0    0    0    0    0
   0    0    0    0    0    0    0    0    0    0    0    0    0    0    0    0    0    0    0    0    0    0    0    0    0    0    0    0    0    0
   0    0    0    0    0    0    0    0    0    0    0    0    0    0    0    0    0    0    0    0    0    0    0    0    0    0    0    0    0    0
   0    0    0    0    0    0    0    0    0    0    0    0    0    0    0    0    0    0    0    0    0    0    0    0    0    0    0    0    0    0
   0    0    0    0    0    0    0    0    0    0    0    0    0    0    0    0    0    0    0    0    0    0    0    0    0    0    0    0    0    0
   0    0    0    0    0    0    0    0    0    0    0    0    0    0    0    0    0    0    0    0    0    0    0    0    0    0    0    0    0    0
   0    0    0    0    0    0    0    0    0    0    0    0    0    0    0    0    0    0    0    0    0    0    0    0    0    0    0    0    0    0
   0    0    0    0    0    0    0    0    0    0    0    0    0    0    0    0    0    0    0    0    0    0    0    0    0    0    0    0    0    0
   0    0    0    0    0    0    0    0    0    0    0    0    0    0    0    0    0    0    0    0    0    0    0    0    0    0    0    0    0    0
   0    0    0    0    0    0    0    0    0    0    0    0    0    0    0    0    0    0    0    0    0    0    0    0    0    0    0    0    0    0
   0    0    0    0    0    0    0    0    0    0    0    0    0    0    0    0    0    0    0    0    0    0    0    0    0    0    0    0    0    0
   0    0    0    0    0    0    0    0    0    0    0    0    0    0    0    0    0    0    0    0    0    0    0    0    0    0    0    0    0    0
   0    0    0    0    0    0    0    0    0    0    0    0    0    0    0    0    0    0    0    0    0    0    0    0    0    0    0    0    0    0
   0    0    0    0    0    0    0    0    0    0    0    0    0    0    0    0    0    0    0    0    0    0    0    0    0    0    0    0    0    0
   0    0    0    0    0    0    0    0    0    0    0    0    0    0    0    0    0    0    0    0    0    0    0    0    0    0    0    0    0    0
   0    0    0    0    0    0    0    0    0    0    0    0    0    0    0    0    0    0    0    0    0    0    0    0    0    0    0    0    0    0
   0    0    0    0    0    0    0    0    0    0    0    0    0    0    0    0    0    0    0    0    0    0    0    0    0    0    0    0    0    0
   0    0    0    0    0    0    0    0    0    0    0    0    0    0    0    0    0    0    0    0    0    0    0    0    0    0    0    0    0    0

   0    0    0    0    0    0    0    0    0    0    0    0    0    0    0    0    0    0    0    0    0    0    0    0    0    0    0    0    0    0
2111 2017 2017 2115    0    0    0    0    0    0    0    0    0    0    0    0    0    0    0    0    0    0    0    0    0    0    0    0    0    0
2111 2017 2017 2115    0    0    0    0    0    0    0    0    0    0    0    0    0    0    0    0    0    0    0    0    0    0    0    0    0    0
2111 2017 2017 2115    0    0    0    0    0    0    0    0    0    0    0    0    0    0    0    0    0    0    0    0    0    0    0    0    0    0
2111 2017 2017 2115    0    0    0    0    0    0    0    0    0    0    0    0    0    0    0    0    0    0    0    0    0 2028    0 2085 2085    0
2111 2017 2017 2115    0    0    0    0    0    0    0    0    0    0    0    0    0    0    0    0    0    0    0    0 2123 2137    0 2026 2026    0
2111 2017 2017 2115    0    0    0    0    0    0    0    0    0    0    0    0    0    0    0    0    0 2024 2024 2108 2109 2109 2129 2026 2026    0
2111 2017 2017 2115    0    0    0    0    0    0    0    0    0    0    0    0    0    0    0    0    0 2108 2109 2129 2111 2111 2113 2109 2109    0
2111 2017 2017 2115    0    0    0    0    0    0    0    0    0    0    0    0    0    0 2024 2024 2024 2024 2111 2111 2111 2113 2129 2111 2111    0
2111 2017 2017 2115 2024    0    0    0 2024 2028 2024 2123 2024 2123 2024 2024    0    0 2108 2109 2109 2109 2109 2109 2109 2129 2111 2111 2111    0
2111 2017 2017 2111 2129 2024 2024 2024 2113 2109 2109 2109 2109 2109 2109 2117    0 2024 2024 2131 2111 2111 2111 2111 2111 2111 2111 2111 2124    0
2111 2019 2019 2019 2115 2113 2109 2109 2129 2111 2111 2111 2111 2111 2115 2024 2024 2113 2109 2109 2109 2129 2111 2111 2111 2124 2110 2110 2117    0
2111 2109 2129 2018 2115 2111 2111 2111 2111 2111 2111 2111 2111 2113 2109 2109 2109 2129 2111 2111 2124 2111 2124 2111 2110 2117    0    0    0    0
2111 2111 2111 2017 2115 2111 2111 2113 2129 2111 2111 2111 2111 2131 2111 2111 2111 2111 2124 2124 2117 2107    0 2107    0    0    0    0    0    0
2111 2111 2115 2017 2115 2111 2111 2111 2111 2111 2111 2111 2111 2111 2111 2111 2111 2115 2123    0    0    0    0    0    0    0    0    0    0    0
2111 2111 2115 2017 2115 2111 2111 2111 2113 2109 2129 2111 2111 2111 2111 2111 2124 2111 2117    0    0    0    0    0    0    0    0    0    0    0
2111 2111 2115 2017 2115 2111 2113 2109 2129 2111 2111 2111 2111 2124 2124 2117    0 2107    0    0    0    0    0    0    0    0    0    0    0    0
2115 2019 2019 2019 2115 2111 2111 2124 2124 2124 2124 2124 2111    0 2053    0    0    0    0    0    0    0    0    0    0    0    0    0    0    0
2111 2018 2113 2109 2111 2113 2109 2117    0    0 2053    0 2107    0 2053    0    0    0    0    0    0    0    0    0    0    0    0 2096 2097    0
2111 2017 2114 2111 2111 2111 2132 2118 2028    0 2053    0    0    0 2053    0    0    0    0    0    0    0    0    0    0    0    0 2097 2097    0
2111 2017 2114 2111 2111 2111 2113 2109 2117    0 2053    0    0    0 2053    0    0    0    0    0    0    0    0    0 2028    0 2113 2109 2109    0
2111 2017 2114 2111 2111 2111 2124 2117    0    0 2053    0    0    0 2053    0    0 2118 2095 2118    0    0 2118 2118 2108 2109 2111 2111 2111    0
2111 2017 2114 2111 2113 2129 2119 2118    0    0 2053    0    0    0 2053    0    0 2108 2109 2117    0 2118 2113 2117 2123 2113 2109 2111 2111    0
2111 2017 2114 2111 2111 2111 2109 2117 2024    0 2053 2024 2024 2024 2053 2024 2024 2024 2114 2109 2109 2109 2111 2109 2109 2109 2109 2109 2111    0
2111 2017 2114 2113 2110 2110 2110 2110 2117    0 2007 2007 2007 2007 2007 2007 2108 2109 2111 2111 2111 2111 2111 2111 2124 2124 2124 2124 2111    0
2111 2017 2114 2111 2124    0    0    0    0    0    0    0    0    0    0    0 2053 2114 2111 2111 2111 2111 2111 2115    0 2118 2118 2123 2108    0
2111 2110 2110 2117    0    0    0    0    0    0    0    0    0    0    0    0 2053 2114 2111 2111 2111 2111 2124 2117    0 2108 2109 2109 2109    0
2111 2017 2115    0    0    0    0    0    0    0    0    0    0    0    0    0 2053 2107 2111 2111 2111 2117    0    0    0 2118 2114 2111 2111    0
2111 2017 2115    0    0    0    0    0    0    0    0    0    0    0    0    0 2053    0 2107 2131 2132 2122 2096 2118 2118 2113 2111 2111 2111    0
2111 2017 2115    0    0    0    0    0    0    0    0    0    0    0    0    0 2053    0 2108 2110 2110 2110 2109 2109 2109 2111 2111 2111 2111    0
2111 2017 2115 2118    0    0    0    0    0    0    0    0    0    0    0    0 2053    0    0    0 2053    0 2114 2111 2111 2111 2111 2111 2111    0
2111 2017 2114 2109 2112 2123    0 2118 2118 2028    0    0    0    0    0    0 2053    0    0    0 2053 2108 2110 2109 2109 2109 2111 2111 2111    0
2111 2017 2114 2111 2113 2109 2109 2110 2110 2117    0    0    0    0    0    0 2053    0    0    0 2053    0 2107 2114 2111 2111 2111 2111 2111    0
2111 2017 2114 2113 2112 2111 2115    0 2107    0    0    0    0    0    0    0 2053    0    0    0 2053    0    0 2114 2109 2109 2109 2111 2111    0
2111 2017 2114 2111 2111 2111 2111 2112 2118 2118    0    0    0    0    0    0 2053    0    0    0 2053    0    0 2108 2111 2111 2109 2109 2111    0
2111 2110 2109 2112 2111 2111 2111 2111 2109 2112 2096    0    0    0    0    0 2053    0    0    0 2053    0    0    0 2114 2111 2111 2111 2109    0
2111 2017 2114 2113 2112 2111 2111 2111 2111 2111 2109 2112 2024 2024 2024 2024 2053 2024    0    0 2053 2024 2024    0 2114 2111 2109 2109 2109    0
2111 2017 2114 2111 2111 2111 2111 2111 2111 2111 2111 2111 2110 2117 2007 2007 2007 2007    0    0 2007 2007 2113 2109 2109 2109 2109 2111 2111    0
2111 2110 2109 2109 2112 2111 2111 2111 2111 2111 2111 2115 2107    0    0    0    0    0    0    0    0    0 2053 2108 2111 2111 2111 2124 2124    0
2111 2017 2111 2111 2111 2109 2109 2112 2111 2111 2111 2115    0    0    0    0    0    0    0    0    0    0 2053    0 2053 2107 2107    0    0    0
2019 2019 2019 2019 2114 2111 2111 2111 2111 2111 2111 2115    0    0    0    0    0    0    0    0    0    0 2053    0 2053    0    0    0    0    0
2113 2109 2110 2110 2124 2111 2111 2111 2113 2109 2109 2109 2112 2119 2118    0    0    0    0    0    0    0 2053    0 2053    0    0    0    0    0
2111 2115    0 2017    0 2108 2111 2111 2111 2111 2111 2113 2109 2109 2117    0    0    0    0    0    0    0 2053    0 2053    0    0    0    0    0
2111 2107    0 2017    0    0 2108 2109 2111 2111 2111 2114 2111 2115 2118    0    0    0    0    0    0    0 2053    0 2053    0    0    0    0    0
2111    0    0 2017    0    0    0    0 2108 2111 2111 2111 2113 2109 2109 2112    0    0    0    0    0    0 2053    0 2053    0    0    0    0    0
2111    0    0 2017    0    0    0    0    0 2114 2124 2111 2114 2111 2111 2111 2112 2119 2118    0    0    0 2053    0 2053    0    0    0    0    0
2111 2112    0 2017    0    0    0    0    0 2107 2122 2113 2109 2109 2112 2111 2109 2109 2117    0    0    0 2053    0 2053    0    0    0    0    0
2111 2115    0 2017    0    0    0    0    0    0 2113 2112 2111 2111 2111 2111 2111 2117    0    0    0    0 2053    0 2053    0    0    0    0    0
2111 2111 2112 2017    0    0    0    0    0 2108 2109 2109 2109 2109 2109 2112    0    0    0    0    0    0 2053 2024 2053 2123 2123 2122    0    0
2111 2111 2109 2110 2112    0 2123 2118    0 2119 2114 2111 2111 2111 2111 2109 2117    0    0    0    0    0 2007 2007 2007 2113 2109 2112    0    0
2111 2111 2115 2017 2115 2109 2109 2109 2109 2109 2109 2112 2111 2113 2117    0    0    0    0    0    0    0    0    0 2118 2114 2111 2115 2122    0
2111 2111 2115 2017 2114 2113 2112 2111 2111 2111 2111 2113 2110 2117    0    0    0    0    0    0    0    0    0    0 2108 2109 2109 2109 2109    0
2111 2111 2115 2017 2114 2111 2111 2111 2111 2111 2111 2115 2107    0    0    0    0    0    0    0    0    0    0    0    0 2108 2111 2111 2111    0
2111 2019 2019 2019 2114 2111 2111 2111 2111 2113 2109 2115    0    0    0    0    0    0    0    0    0    0    0    0    0    0 2111 2111 2111    0
2111 2109 2109 2109 2112 2111 2113 2109 2112 2111 2111 2115 2024 2024    0    0    0    0    0    0    0    0    0    0    0    0 2107 2108 2109    0
2111 2017 2111 2111 2111 2111 2111 2111 2111 2111 2113 2109 2109 2112 2118 2118 2122    0 2025    0 2028 2025    0    0    0    0    0    0    0    0
2111 2017 2124 2124 2111 2111 2111 2111 2111 2113 2109 2112 2111 2111 2109 2109 2109 2109 2109 2109 2109 2117    0    0    0    0    0    0    0    0
2111 2017    0    0 2108 2111 2111 2111 2111 2111 2111 2111 2111 2111 2111 2111 2111 2111 2111 2111 2111    0    0    0    0    0    0    0    0    0
2111 2017    0 2118 2118 2113 2109 2109 2109 2109 2109 2112 2111 2111 2111 2111 2111 2109 2109 2117 2107    0    0    0    0    0    0    0    0    0
2111 2017 2123 2113 2109 2112 2111 2111 2111 2111 2111 2115 2111 2124 2124 2124 2109 2117 2107    0    0    0    0    0    0    0    0    0    0    0
2111 2018 2113 2109 2112 2111 2111 2111 2111 2111 2109 2109 2117    0    0    0    0    0    0    0    0    0    0    0    0    0    0    0    0    0
2111 2017 2114 2111 2111 2111 2111 2111 2111 2111 2115 2107    0    0    0    0    0    0    0    0    0    0    0    0    0    0    0    0    0    0
2111 2017 2114 2111 2111 2113 2109 2109 2109 2109 2117    0    0    0    0    0    0    0    0    0    0    0    0    0    0    0    0    0    0    0
2111 2019 2019 2019 2114 2111 2111 2111 2111 2124 2117    0    0    0    0    0    0    0    0    0    0    0    0    0    0    0    0    0    0    0
2111 2113 2112 2017 2113 2112 2111 2111 2111 2123    0    0    0    0    0    0    0    0    0    0    0    0    0    0    0    0    0    0    0    0
2111 2111 2115 2017 2109 2109 2112 2111 2113 2112 2024 2024    0    0    0    0    0    0    0    0    0    0    0    0    0    0    0    0    0    0
2111 2111 2115 2017 2114 2111 2111 2111 2114 2111 2109 2112 2123 2119    0 2118    0    0    0    0    0    0    0    0    0    0    0    0    0    0
2111 2111 2115 2017 2114 2111 2109 2109 2109 2112 2111 2109 2109 2109 2109 2117    0    0    0    0    0    0    0    0    0    0    0    0    0    0
2111 2019 2019 2019 2113 2109 2112 2111 2111 2111 2111 2111 2111 2111 2111    0    0    0    0    0    0    0    0    0    0    0    0    0    0    0
2111 2113 2109 2109 2112 2111 2111 2111 2111 2113 2109 2109 2112 2115 2107    0    0    0    0    0    0    0    0    0    0    0    0    0    0    0
2111 2017 2114 2111 2111 2111 2111 2111 2111 2114 2111 2111 2115 2115    0    0    0    0    0    0    0    0    0    0    0    0    0    0    0    0
2111 2017 2111 2124 2124 2111 2111 2113 2109 2109 2112 2111 2115 2115    0    0    0    0    0    0    0    0    0    0    0    0    0    0    0    0
2111 2018 2110 2117    0 2108 2112 2111 2111 2111 2111 2111 2115 2115 2122 2024    0    0    0    0    0    0    0    0    0    0    0    0    0    0
2111 2017    0    0    0    0 2111 2111 2111 2111 2111 2111 2111 2109 2109 2112 2123    0    0    0    0    0    0    0    0    0    0    0    0    0
2111 2017    0    0    0    0 2108 2109 2112 2111 2111 2113 2109 2109 2109 2109 2112    0    0    0    0    0    0    0    0    0    0 2108 2109    0
2111 2017    0    0    0    0    0 2108 2109 2112 2111 2111 2111 2111 2111 2111 2115    0    0    0    0    0    0    0    0    0    0    0 2114    0
2111 2017    0    0    0    0    0    0 2114 2111 2112 2111 2111 2111 2111 2111 2115 2123 2118    0    0    0    0    0    0    0 2085 2085 2085    0
2111 2085 2085 2085 2085    0    0 2118 2114 2111 2111 2111 2111 2111 2113 2109 2109 2109 2117    0    0    0    0    0    0    0 2026 2026 2026    0
2111 2112 2026 2026 2026 2118 2119 2113 2109 2109 2109 2109 2109 2109 2109 2112 2111 2113 2109 2112    0 2128 2028 2123    0    0 2026 2026 2026    0
2111 2115 2026 2113 2109 2109 2109 2109 2112 2111 2111 2111 2111 2111 2111 2112 2109 2109 2109 2109 2109 2109 2109 2109 2109 2109 2109 2109 2109    0
2111 2115 2026 2111 2111 2111 2111 2111 2111 2111 2111 2111 2111 2111 2111 2111 2111 2111 2111 2111 2111 2111 2111 2111 2111 2111 2111 2111 2111    0
2111 2115 2026 2111 2111 2111 2111 2111 2111 2111 2111 2111 2111 2111 2111 2111 2111 2111 2111 2111 2111 2111 2111 2111 2111 2111 2111 2111 2111    0
2111 2115 2026 2111 2111 2111 2111 2111 2111 2111 2111 2111 2111 2111 2111 2111 2111 2111 2111 2111 2111 2111 2111 2111 2111 2111 2111 2111 2111    0
2111 2115 2026 2111 2111 2111 2111 2111 2111 2111 2111 2111 2111 2111 2111 2111 2111 2111 2111 2111 2111 2111 2111 2111 2111 2111 2111 2111 2111    0
2111 2115 2026 2111 2111 2111 2111 2111 2111 2111 2111 2111 2111 2111 2111 2111 2111 2111 2111 2111 2111 2111 2111 2111 2111 2111 2111 2111 2111    0
2111 2115 2026 2111 2111 2111 2111 2111 2111 2111 2111 2111 2111 2111 2111 2111 2111 2111 2111 2111 2111 2111 2111 2111 2111 2111 2111 2111 2111    0
