86
30
   9    9    9    9    9    9    9    9    9    9    9    9    9    9    9    9    9    9    9    9    9    9    9    9    9    9    9    9    9    9
   9    0    0    1    0    0    0    0    0    0    0    0    0    0    0    0    0    0    0    0    0    0    0    0    0    0    0    0    0    9
   9    0    0    1    0    0    0    0    0    0    0    0    0    0    0    0    0    0    0    0    0    0    0    0    0    0    0    0    0    9
   9    0    0    1    0    0    0    0    0    0    0    0    0    0    0    0    0    0    0    0    0    0    0    0    0    0    0    0    0    9
   9    0    0    1    0    0    0    0    0    0    0    0    0    0    0    0    0    0    0    0    0    0    0    0    0    0    0    0    0    9
   9    0    0    1    0    0    0    0    0    0    0    0    0    0    0    0    0    0    0    0    0    0    0    0    0    0    0    0    0    9
   9    0    0    1    0    0    0    0    0    0    0    0    0    0    0    0    0    0    0    0    0    0    0    4    4    4    4    0    0    9
   9    0    0    1    0    0    0    0    0    0    0    0    0    0    0    0    0    0    0    0    0    4    4    4    0    0    4    4    4    9
   9    0    0    1    0    0    0    0    0    0    0    0    0    0    0    0    0    0    0    0    0    0    0    0    0    4    4    0    0    9
   9    0    0    1    0    0    0    0    0    0    0    0    0    0    0    0    0    0    4    4    4    4    4    4    4    4    0    0    0    9
   9    0    0    0    9    0    0    0    4    4    4    4    4    4    4    4    0    0    0    0    0    0    0    0    0    0    0    0    0    9
   9    4    4    0    9    4    4    4    4    0    0    0    0    0    0    0    0    4    4    4    4    4    0    0    0    0    4    4    4    9
   9    0    0    0    1    0    0    0    0    0    0    0    0    4    4    4    4    4    0    0    0    0    0    0    4    4    0    0    0    9
   9    0    0    0    1    0    0    4    4    0    0    0    0    0    0    0    0    0    0    0    4    0    0    0    0    0    0    0    0    9
   9    0    0    0    1    0    0    0    0    0    0    0    0    0    0    0    0    0    0    0    0    0    0    0    0    0    0    0    0    9
   9    0    0    0    1    0    0    0    4    4    4    0    0    0    0    0    0    0    4    0    0    0    0    0    0    0    0    0    0    9
   9    0    0    0    1    0    4    4    4    0    0    0    0    0    0    0    0    0    0    0    0    0    0    0    0    0    0    0    0    9
   9    0    0    0    1    0    0    0    0    0    0    0    0    0    0    0    0    0    0    0    0    0    0    0    0    0    0    0    0    9
   9    0    4    4    0    4    4    4    0    0    0    0    0    0    0    0    0    0    0    0    0    0    0    0    0    0    0    0    0    9
   9    0    0    0    0    0    0    0    0    0    0    0    0    0    0    0    0    0    0    0    0    0    0    0    0    0    0    0    0    9
   9    0    0    0    0    0    4    4    4    0    0    0    0    0    0    0    0    0    0    0    0    0    0    0    0    0    4    4    4    9
   9    0    0    0    0    0    0    4    0    0    0    0    0    0    0    0    0    0    0    0    0    0    0    0    4    4    0    0    0    9
   9    0    0    0    4    4    0    0    0    0    0    0    0    0    0    0    0    4    4    4    0    0    4    4    0    4    4    0    0    9
   9    0    0    0    0    0    4    4    0    0    0    0    0    0    0    0    0    0    0    4    4    4    0    4    4    4    4    4    0    9
   9    0    0    4    4    4    4    4    4    0    4    4    4    4    4    4    4    4    0    0    0    0    0    0    0    0    0    0    0    9
   9    0    0    0    0    0    0    0    0    0    0    0    0    0    0    0    0    0    0    0    0    0    0    0    0    0    0    0    4    9
   9    4    4    4    0    0    0    0    0    0    0    0    0    0    0    0    0    0    0    0    0    0    0    0    0    4    4    4    4    9
   9    0    0    0    0    0    0    0    0    0    0    0    0    0    0    0    0    0    0    0    0    0    0    0    0    0    0    0    0    9
   9    0    0    0    0    0    0    0    0    0    0    0    0    0    0    0    0    0    0    0    0    0    0    0    0    4    0    0    0    9
   9    0    0    0    0    0    0    0    0    0    0    0    0    0    0    0    0    0    4    4    4    4    4    4    4    0    0    0    0    9
   9    0    0    0    0    0    0    0    0    0    0    0    0    0    0    0    0    0    0    0    0    0    0    0    0    0    0    0    0    9
   9    0    0    4    4    0    0    0    0    0    0    0    0    0    0    0    0    0    0    0    0    4    4    4    4    4    0    0    0    9
   9    0    0    0    4    4    4    4    4    4    0    0    0    0    0    0    0    0    0    0    0    0    0    0    0    0    0    0    0    9
   9    0    0    4    4    0    0    0    0    0    0    0    0    0    0    0    0    0    0    0    0    0    0    0    4    4    4    0    0    9
   9    0    0    0    0    0    0    4    0    0    0    0    0    0    0    0    0    0    0    0    0    0    0    4    0    0    4    4    0    9
   9    4    4    4    0    0    0    0    4    4    0    0    0    0    0    0    0    0    0    0    0    0    0    0    0    0    0    0    4    9
   9    0    0    4    4    0    0    0    0    0    4    4    0    0    0    0    0    0    0    0    0    0    0    0    0    0    4    4    4    9
   9    0    0    0    0    0    0    0    0    0    0    0    4    4    4    4    4    4    0    0    4    4    4    4    4    4    4    0    0    9
   9    4    4    4    4    0    0    0    0    0    0    0    0    0    0    0    0    0    0    0    0    0    0    4    0    0    0    0    0    9
   9    0    0    0    0    4    4    4    0    0    0    0    0    0    0    0    0    0    0    0    0    0    0    0    0    0    0    0    0    9
   9    0    0    0    0    0    0    0    0    0    0    0    0    0    0    0    0    0    0    0    0    0    0    0    0    0    0    0    0    9
   9    4    4    4    0    0    0    0    4    4    4    4    4    0    0    0    0    0    0    0    0    0    0    0    0    0    0    0    0    9
   9    0    0    0    0    4    0    0    0    0    0    4    4    4    4    0    0    0    0    0    0    0    0    0    0    0    0    0    0    9
   9    0    0    0    0    0    4    4    0    0    0    0    0    0    0    0    0    0    0    0    0    0    0    0    0    0    0    0    0    9
   9    0    0    0    0    0    0    0    4    0    0    0    4    4    4    4    0    0    0    0    0    0    0    0    0    0    0    0    0    9
   9    0    0    0    0    0    0    0    0    0    0    0    0    0    0    0    4    0    0    0    0    0    0    0    0    0    0    0    0    9
   9    7    0    0    0    0    0    0    0    0    0    4    4    4    4    0    4    4    4    0    0    0    0    0    0    0    0    0    0    9
   9    1    0    0    0    0    0    0    0    0    4    4    0    0    0    0    0    4    0    0    0    0    0    0    0    0    0    0    0    9
   9    0    7    0    0    0    0    0    0    4    4    4    4    4    4    4    0    0    0    0    0    0    0    0    0    0    0    0    0    9
   9    0    4    4    7    0    0    0    0    0    0    0    0    0    0    4    4    0    0    0    0    0    4    4    4    4    4    4    0    9
   9    0    0    0    0    4    4    4    4    4    4    4    0    4    4    0    0    0    0    0    0    0    0    0    0    0    0    0    0    9
   9    0    0    0    0    4    4    0    0    0    0    4    4    4    0    0    0    0    0    0    0    0    0    0    4    4    4    4    4    9
   9    0    0    0    0    0    0    0    0    0    0    0    0    0    0    0    0    0    0    0    0    0    0    0    0    4    0    0    0    9
   9    0    0    0    0    0    0    0    0    4    4    0    0    0    0    0    0    0    0    0    0    0    0    0    0    0    0    0    0    9
   9    4    4    4    4    0    4    4    4    0    0    0    0    0    0    0    0    0    0    0    0    0    0    0    0    0    0    4    4    9
   9    0    0    0    0    0    0    0    0    0    4    4    4    4    0    0    0    0    0    0    0    0    0    0    0    0    0    0    0    9
   9    0    0    0    0    0    0    0    0    4    4    4    0    0    4    4    4    4    4    4    4    4    0    0    0    0    0    0    0    9
   9    0    0    0    4    0    0    0    0    0    0    0    0    0    0    0    0    0    0    0    0    0    0    0    0    0    0    0    0    9
   9    0    0    0    0    4    4    4    4    4    4    4    0    0    0    0    0    4    4    4    0    0    0    0    0    0    0    0    0    9
   9    0    0    4    4    4    0    0    0    0    0    0    0    0    0    0    4    4    0    0    0    0    0    0    0    0    0    0    0    9
   9    0    4    4    4    0    0    0    0    0    4    4    4    0    0    0    0    0    0    0    0    0    0    0    0    0    0    0    0    9
   9    0    0    0    0    0    0    0    0    0    0    0    0    0    0    0    0    0    0    0    0    0    0    0    0    0    0    0    0    9
   9    0    0    0    0    4    4    4    4    4    4    0    0    0    0    0    0    0    0    0    0    0    0    0    0    0    0    0    0    9
   9    0    0    0    0    0    0    0    0    0    4    0    0    0    0    0    0    0    0    0    0    0    0    0    0    0    0    0    0    9
   9    4    4    0    4    4    0    0    0    0    0    0    0    0    0    0    0    0    0    0    0    0    0    0    0    0    0    0    0    9
   9    0    0    0    4    4    4    0    4    4    0    0    0    0    0    0    0    0    0    0    0    0    0    0    0    0    0    0    0    9
   9    0    0    0    0    0    0    0    0    0    4    4    0    0    0    0    0    0    0    0    0    0    0    0    0    0    0    0    0    9
   9    0    0    0    0    0    4    4    4    4    0    4    4    4    4    4    0    0    0    0    0    0    0    0    0    0    0    0    0    9
   9    0    0    0    4    4    4    0    0    0    0    0    0    0    0    0    0    0    0    0    0    0    0    0    0    0    0    0    0    9
   9    4    4    4    4    0    0    0    0    4    4    4    4    0    0    0    0    0    0    0    0    0    0    0    0    0    0    0    0    9
   9    0    0    0    0    0    0    0    0    0    0    0    0    0    0    0    0    0    0    0    0    0    0    0    0    0    0    0    0    9
   9    0    0    0    0    0    0    4    4    4    4    0    0    0    0    0    0    0    0    0    0    0    0    0    0    0    0    0    0    9
   9    0    4    4    0    4    4    0    0    0    0    0    0    0    0    0    0    0    0    0    0    0    0    0    0    0    0    0    0    9
   9    0    0    0    0    0    0    0    0    0    0    0    0    4    4    4    0    0    0    0    0    0    0    0    0    0    0    0    0    9
   9    0    0    0    0    0    4    4    4    0    0    4    4    4    4    4    4    0    0    0    0    0    0    0    0    0    0    4    4    9
   9    0    0    0    0    0    0    4    4    4    0    0    0    0    0    0    0    0    0    0    0    0    0    0    0    0    0    0    0    9
   9    0    0    0    0    0    0    0    0    0    4    0    0    0    0    0    0    0    0    0    0    0    0    0    0    0    0    0    0    9
   9    0    0    0    0    0    0    0    0    0    0    0    0    0    4    4    4    4    4    0    0    0    0    0    0    0    0    0    0    9
   9    9    0    0    0    0    0    8    4    4    4    4    4    4    4    7    0    4    4    4    0    0    0    0    0    0    0    0    0    9
   9    9    0    8    4    4    4    4    4    0    0    0    0    0    0    4    4    4    4    4    4    4    4    4    4    4    4    4    4    9
   9    9    0    9    0    0    0    0    0    0    0    0    0    0    0    0    0    0    0    0    0    0    0    0    0    0    0    0    0    9
   9    9    9    9    0    0    0    0    0    0    0    0    0    0    0    0    0    0    0    0    0    0    0    0    0    0    0    0    0    9
   9    9    0    9    0    0    0    0    0    0    0    0    0    0    0    0    0    0    0    0    0    0    0    0    0    0    0    0    0    9
   9    9    0    9    0    0    0    0    0    0    0    0    0    0    0    0    0    0    0    0    0    0    0    0    0    0    0    0    0    9
   9    9    0    9    0    0    0    0    0    0    0    0    0    0    0    0    0    0    0    0    0    0    0    0    0    0    0    0    0    9
   9    9    9    9    9    9    9    9    9    9    9    9    9    9    9    9    9    9    9    9    9    9    9    9    9    9    9    9    9    9
