19
118
   0    0    0    0    0    0    0    0    0    0    0    0    0    0    0    0    0    0    0    0    0    0    0    0    0    0    0    0    0    0    0    0    0    0    0    0 2053    0    0 2053    0    0    0    0    0    0    0    0    0    0    0    0    0    0    0    0    0    0    0    0    0    0    0    0    0    0    0    0    0    0    0    0    0    0    0    0    0    0    0    0    0    0    0 2053 2053    0    0    0 2053    0 2053    0    0    0    0    0    0    0    0    0    0    0    0    0    0    0    0    0    0    0    0 2055 2026 2026 2026 2026 2026 2055
   0    0    0    0    0    0    0    0    0    0    0    0    0    0    0    0    0    0    0    0    0    0    0    0    0    0    0    0    0    0    0    0 2011    0    0    0 2053 2029    0 2053    0    0    0    0    0    0    0    0    0    0    0    0    0    0    0    0    0    0    0    0    0    0    0    0    0    0    0    0    0    0    0    0    0    0    0    0    0    0    0    0    0    0    0 2053 2053    0    0    0 2053    0 2053    0    0    0    0    0 2034    0    0    0    0    0    0    0    0    0    0    0    0    0    0 2055 2026 2026 2026 2026 2026 2055
   0    0    0    0    0    0    0    0    0    0    0    0    0    0    0    0    0    0    0    0    0    0    0    0    0    0    0    0    0    0    0    0 2034 2011 2011    0 2053 2084 2029 2053    0 2080 2078 2078 2078 2078 2078 2078 2078 2078 2081    0    0    0    0    0    0    0    0    0    0    0    0    0    0    0    0    0    0    0    0    0    0    0    0    0    0    0    0    0    0    0    0 2053 2053    0    0    0 2053    0 2053    0    0    0    0 2011 2033    0    0 2011    0    0    0    0    0    0    0    0    0    0    0 2055 2026 2026 2026 2026 2026 2055
2118    0    0    0    0    0    0    0    0    0    0    0    0    0    0    0    0    0    0    0    0    0    0    0    0    0    0    0    0 2084    0    0 2033    0    0    0 2053 2084 2084 2053    0 2082 2076 2076 2076 2076 2076 2076 2076 2076 2083    0    0    0    0    0    0    0    0    0    0    0    0    0    0    0    0    0    0    0    0    0    0    0    0    0    0    0    0    0    0    0    0 2053 2053    0 2084    0 2053    0 2053    0    0    0 2011    0 2033    0    0 2034    0    0    0    0    0    0    0    0    0    0    0 2055 2026 2026 2026 2054 2054 2055
2085 2085    0    0    0    0 2118    0    0    0    0    0    0    0    0    0    0    0    0 2071 2073 2073 2073 2073 2073 2073 2073 2073 2073 2073 2073 2072 2033    0    0 2011 2007 2007 2007 2007    0 2093 2055 2056 2056 2067 2067 2056 2056 2055 2093    0    0    0    0    0 2011    0 2011 2011    0    0    0    0    0    0    0 2011 2034    0    0    0    0    0    0    0    0    0    0    0    0    0    0 2053 2053    0 2084 2084 2053    0 2053    0 2011    0 2011    0 2033    0    0 2033    0    0    0    0    0    0    0    0    0 2136    0 2055 2026 2026 2026 2026 2026 2055
2026 2026    0    0 2118 2113 2112    0    0    0    0    0    0    0 2080 2078 2078 2078 2081 2071 2074 2074 2074 2074 2074 2074 2074 2074 2074 2074 2074 2072 2033    0    0 2011    0    0    0    0    0    0 2055 2058 2058 2068 2068 2058 2058 2055    0    0    0    0    0 2011 2011    0 2034    0    0 2011    0    0    0    0    0 2093 2033 2080 2078 2078 2078 2078 2081 2034    0    0    0    0    0    0    0 2053 2053 2084 2084 2084 2053    0 2053    0 2034    0 2093 2011 2033    0    0 2033    0    0    0    0    0    0    0    0    0 2061    0 2055 2026 2026 2054 2054 2054 2055
2026 2026    0 2108 2109 2109 2111    0    0    0    0    0    0    0 2082 2076 2076 2076 2083    0 2101 2070 2070 2070 2070 2070 2070 2070 2070 2070 2101    0 2033    0    0 2011    0    0    0    0    0 2080 2079 2079 2079 2079 2079 2079 2079 2079 2081    0    0    0 2029    0    0    0 2033    0    0 2034    0    0    0    0    0 2011 2033 2082 2076 2076 2076 2076 2083 2033    0    0    0 2011    0 2011    0 2053 2007 2007 2007 2007 2007    0 2053 2011 2033    0    0    0 2033    0    0 2033    0    0    0    0    0    0    0    0 2054 2054 2054 2055 2026 2026 2026 2026 2026 2055
2109 2112    0    0    0 2114 2111 2112    0    0    0    0    0    0 2093 2055    0 2055 2093    0 2055 2067 2066 2067 2066 2067 2066 2067 2066 2067 2055 2136 2033    0    0    0 2118 2084    0    0    0 2082 2076 2076 2076 2076 2076 2076 2076 2076 2083    0    0    0 2084 2029 2011    0 2033 2011    0 2033 2011    0    0    0    0 2011 2033 2093 2055    0    0 2055 2093 2033    0    0    0 2011    0    0    0 2053 2084 2084 2084 2084 2084 2084 2053 2011 2033    0 2084    0 2033    0    0 2033    0    0    0 2123    0    0    0    0 2012    0    0 2055 2026 2054 2054 2054 2054 2055
2111 2111 2112 2016 2108 2109 2109 2109 2112 2016 2015 2016    0    0 2024 2055    0 2055    0 2136 2055 2062 2058 2062 2058 2062 2058 2062 2058 2062 2055 2084 2033    0    0 2121 2084 2061 2084    0 2027 2027 2055 2056 2056 2067 2067 2056 2056 2055 2027 2027 2084 2084 2061 2084    0    0 2033    0    0 2033    0 2011    0    0    0    0 2033    0 2055    0    0 2055    0 2033    0    0    0    0    0 2011    0 2007 2007 2007 2007 2007 2007 2007 2007    0 2033    0 2005 2001 2001 2004 2018 2005 2001 2004 2018 2005 2004    0    0 2118 2012    0    0 2055 2026 2101 2026 2101 2026 2055
2111 2111 2111 2109 2109 2109 2109 2109 2109 2109 2109 2117    0    0 2054 2054 2054 2054 2054 2054 2054 2054 2054 2054 2054 2054 2054 2054 2054 2054 2054 2037 2001 2001 2001 2001 2004 2061 2061 2066 2066 2066 2055 2058 2058 2068 2068 2058 2058 2055 2066 2066 2084 2061 2061 2061    0    0 2033    0    0 2033    0    0    0    0 2011    0 2033    0 2055    0    0 2055    0 2033    0 2011    0    0    0    0    0    0    0    0    0    0    0    0    0    0 2033 2084 2020 2022 2022 2021 2017 2020 2022 2021 2017 2020 2021 2118 2025 2037 2036    0    0 2055 2026 2055 2026 2055 2026 2055
2111 2111 2111 2111 2111 2111 2111 2111 2111 2111 2115    0    0    0    0    0    0    0    0    0 2055    0    0    0    0    0    0    0    0    0 2055 2038 2022 2022 2022 2022 2021 2054 2054 2054 2054 2054 2054 2054 2054 2054 2054 2054 2054 2054 2054 2054 2054 2054 2054 2054 2037 2036 2033    0    0 2033    0    0    0    0 2028    0 2033    0 2054 2054 2054 2054    0 2033    0    0    0 2037 2001 2001 2001 2036    0    0 2029    0    0 2084    0 2061 2033 2037 2001 2036 2022 2021 2017 2020 2037 2001 2001 2001 2001 2001 2001 2038 2039 2054 2054 2054 2054 2054 2054 2054 2054 2054
2111 2111 2111 2111 2111 2111 2111 2111 2111 2111 2115 2019 2019 2019 2019 2019 2019 2019 2019 2019 2019 2019 2019 2019 2019 2019 2019 2019 2019 2019 2019 2038 2022 2022 2022 2022 2022 2006 2006 2006 2006 2006 2006 2006 2006 2006 2006 2006 2006 2006 2006 2006 2006 2006 2006 2006 2006 2001 2001 2036 2118 2033    0    0 2024 2024 2037 2001 2001 2001 2001 2001 2001 2001 2001 2001 2001 2001 2001 2022 2022 2022 2022 2022 2036    0 2137    0 2084 2061 2061 2037 2001 2001 2036 2022 2037 2036 2017 2037 2001 2036 2017 2020 2022 2022 2022 2038 2022 2006 2006 2006 2006 2006 2006 2006 2006 2006
2111 2111 2111 2111 2111 2111 2111 2111 2111 2111 2115 2006 2006 2006 2006 2006 2006 2006 2006 2006 2006 2006 2006 2006 2006 2006 2006 2006 2006 2006 2006 2038 2022 2022 2022 2022 2022 2022 2022 2022 2022 2022 2022 2022 2022 2022 2022 2022 2022 2022 2022 2022 2022 2022 2022 2022 2022 2022 2022 2037 2001 2001 2001 2001 2001 2001 2001 2022 2022 2022 2022 2022 2022 2022 2022 2022 2022 2022 2022 2022 2001 2001 2001 2001 2001 2001 2001 2001 2001 2001 2022 2022 2022 2022 2039 2019 2019 2019 2019 2019 2019 2019 2019 2019 2019 2019 2019 2038 2022 2022 2022 2022 2022 2022 2022 2022 2022 2022
2111 2111 2111 2111 2111 2111 2111 2111 2111 2111 2115 2022 2022 2022 2022 2022 2022 2022 2022 2022 2022 2022 2022 2022 2022 2022 2022 2022 2022 2022 2022 2038 2022 2022 2022 2022 2022 2022 2022 2022 2022 2022 2022 2022 2022 2022 2022 2022 2022 2022 2022 2022 2022 2022 2022 2022 2022 2022 2022 2022 2022 2022 2022 2022 2022 2022 2022 2022 2022 2022 2022 2022 2022 2022 2022 2022 2022 2022 2022 2022 2022 2022 2022 2022 2022 2022 2022 2022 2022 2022 2022 2022 2022 2022 2039 2022 2022 2022 2022 2022 2022 2022 2022 2022 2022 2022 2022 2038 2022 2022 2022 2022 2022 2022 2022 2022 2022 2022
2111 2111 2111 2111 2111 2111 2111 2111 2111 2111 2115 2022 2022 2022 2022 2022 2022 2022 2022 2022 2022 2022 2022 2022 2022 2022 2022 2022 2022 2022 2022 2038 2022 2022 2022 2022 2022 2022 2022 2022 2022 2022 2022 2022 2022 2022 2022 2022 2022 2022 2022 2022 2022 2022 2022 2022 2022 2022 2022 2022 2022 2022 2022 2022 2022 2022 2022 2022 2022 2022 2022 2022 2022 2022 2022 2022 2022 2022 2022 2022 2022 2022 2022 2022 2022 2022 2022 2022 2022 2022 2022 2022 2022 2022 2039 2022 2022 2022 2022 2022 2022 2022 2022 2022 2022 2022 2022 2038 2022 2022 2022 2022 2022 2022 2022 2022 2022 2022
2111 2111 2111 2111 2111 2111 2111 2111 2111 2111 2115 2022 2022 2022 2022 2022 2022 2022 2022 2022 2022 2022 2022 2022 2022 2022 2022 2022 2022 2022 2022 2038 2022 2022 2022 2022 2022 2022 2022 2022 2022 2022 2022 2022 2022 2022 2022 2022 2022 2022 2022 2022 2022 2022 2022 2022 2022 2022 2022 2022 2022 2022 2022 2022 2022 2022 2022 2022 2022 2022 2022 2022 2022 2022 2022 2022 2022 2022 2022 2022 2022 2022 2022 2022 2022 2022 2022 2022 2022 2022 2022 2022 2022 2022 2039 2022 2022 2022 2022 2022 2022 2022 2022 2022 2022 2022 2022 2038 2022 2022 2022 2022 2022 2022 2022 2022 2022 2022
2111 2111 2111 2111 2111 2111 2111 2111 2111 2111 2115 2022 2022 2022 2022 2022 2022 2022 2022 2022 2022 2022 2022 2022 2022 2022 2022 2022 2022 2022 2022 2038 2022 2022 2022 2022 2022 2022 2022 2022 2022 2022 2022 2022 2022 2022 2022 2022 2022 2022 2022 2022 2022 2022 2022 2022 2022 2022 2022 2022 2022 2022 2022 2022 2022 2022 2022 2022 2022 2022 2022 2022 2022 2022 2022 2022 2022 2022 2022 2022 2022 2022 2022 2022 2022 2022 2022 2022 2022 2022 2022 2022 2022 2022 2039 2022 2022 2022 2022 2022 2022 2022 2022 2022 2022 2022 2022 2038 2022 2022 2022 2022 2022 2022 2022 2022 2022 2022
2111 2111 2111 2111 2111 2111 2111 2111 2111 2111 2115 2022 2022 2022 2022 2022 2022 2022 2022 2022 2022 2022 2022 2022 2022 2022 2022 2022 2022 2022 2022 2038 2022 2022 2022 2022 2022 2022 2022 2022 2022 2022 2022 2022 2022 2022 2022 2022 2022 2022 2022 2022 2022 2022 2022 2022 2022 2022 2022 2022 2022 2022 2022 2022 2022 2022 2022 2022 2022 2022 2022 2022 2022 2022 2022 2022 2022 2022 2022 2022 2022 2022 2022 2022 2022 2022 2022 2022 2022 2022 2022 2022 2022 2022 2039 2022 2022 2022 2022 2022 2022 2022 2022 2022 2022 2022 2022 2038 2022 2022 2022 2022 2022 2022 2022 2022 2022 2022
2111 2111 2111 2111 2111 2111 2111 2111 2111 2111 2115 2022 2022 2022 2022 2022 2022 2022 2022 2022 2022 2022 2022 2022 2022 2022 2022 2022 2022 2022 2022 2038 2022 2022 2022 2022 2022 2022 2022 2022 2022 2022 2022 2022 2022 2022 2022 2022 2022 2022 2022 2022 2022 2022 2022 2022 2022 2022 2022 2022 2022 2022 2022 2022 2022 2022 2022 2022 2022 2022 2022 2022 2022 2022 2022 2022 2022 2022 2022 2022 2022 2022 2022 2022 2022 2022 2022 2022 2022 2022 2022 2022 2022 2022 2039 2022 2022 2022 2022 2022 2022 2022 2022 2022 2022 2022 2022 2038 2022 2022 2022 2022 2022 2022 2022 2022 2022 2022
