19
12
0 0 0 0 0 0 0 0 0 0 0 0
0 0 0 0 0 0 0 0 0 0 0 0
0 0 0 0 0 0 0 0 0 0 0 0
0 0 0 0 0 0 0 0 0 0 0 0
0 0 0 0 0 0 0 0 0 0 0 0
0 0 0 0 0 0 0 0 0 0 0 0
2118 0 0 0 0 0 0 0 0 0 0 0
2085 2085 0 0 0 0 2118 0 0 0 0 0
2026 2026 0 0 2118 2113 2112 0 0 0 0 0
2026 2026 0 2108 2109 2109 2111 0 0 0 0 0
2109 2112 0 0 0 2114 2111 2112 0 0 0 0
2111 2111 2112 2016 2108 2109 2109 2109 2112 2016 2015 2016
2111 2111 2111 2109 2109 2109 2109 2109 2109 2109 2109 2117
2111 2111 2111 2111 2111 2111 2111 2111 2111 2111 2115 0
2111 2111 2111 2111 2111 2111 2111 2111 2111 2111 2115 0
2111 2111 2111 2111 2111 2111 2111 2111 2111 2111 2115 0
2111 2111 2111 2111 2111 2111 2111 2111 2111 2111 2115 0
2111 2111 2111 2111 2111 2111 2111 2111 2111 2111 2115 0
2111 2111 2111 2111 2111 2111 2111 2111 2111 2111 2115 0